150:255:140:120:90:90:
1111110111011110111
1000000110000110001
1000000110000110001
1110000110000000001
1000011110000110001
1000000000000110001
1000000000000110001
1000001100000110001
1000001100000110000
1000000000000110101
1000000000000110001
1111111011111111111 